BBBBBBBBBBBBBBBBBBBBBBBBBBBBBBBBBBBBBBBBBBBBBBBBBBBBBBBBBBBBBBBBBBBBBBBBBBBBBBBBBBBBBBBBBBBBBB
BBBBBBBBBBBBBBBBBBBBBBBBBBBBBBBBBBBBBBBBBBBBBBBBBBBBBBBBBBBBBBBBBBBBBBBBBBBBBBBBBBBBBBBBBBBBBB
BBBBBBBBBBBBBBBBBBBBBBBBBBBBBBBBBBBBBBBBBBBBBBBBBBBBBBBBBBBBBBBBBBBBBBBBBBBBBBBBBBBBBBBBBBBBBB
BBBBBBBBBBBBBBBBBBBBBBBBBBBBBBBBBBBBBBBBBBBBBBBBBBBBBBBBBBBBBBBBBBBBBBBBBBBBBBBBBBBBBBBBBBBBBB
BBBBBBBBBBBBBBBBBBBBBBBBBBBBBBBBBBBBBBBBBBBBBBBBBBBBBBBBBBBBBBBBBBBBBBBBBBBBBBBBBBBBBBBBBBBBBB
BBBBBBBBBBBBBBBBBBBBBBBBBBBBBBBBBBBBBBBBBBBBBBBBBBBBBBBBBBBBBBBBBBBBBBBBBBBBBBBBBBBBBBBBBBBBBB
BBBBBBBBBBBBBBBBBBBBBBBBBBBBBBBBBBBBBBBBBBBBBBBBBBBBBBBBBBBBBBBBBBBBBBBBBBBBBBBBBBBBBBBBBBBBBB
BBBBBBBBBFFFFFFFFFFFFFFFFBBBBBBBBBBBBFFFFFFFFFFFFFFFFFBBBBBBBBBBBBBBBBBBBBBBBBBBBBBBBBBBBBBBBB
BBBBBBBBBFFFFFFFFFFFFFFFFBBBBBBBBBBBBFFFFFFFFFFFFFFFFFBBBBBBBBBBBBBBBBBBBBBBBBBBBBBBBBBBBBBBBB
BBBBBBBBBFFFFFFFFFFFFFFFFBBBBBBBBBBBBFFFFFFFFFFFFFFFFFBBBBBBBBBBFFFFFFFFFFFFFFFFFFFFFBBBBBBBBB
BBBBBBBBBFFFFFFFFFFFFFFFFBBBBBBBBBBBBFFFFFFFFFFFFFFFFFBBBBBBBBBBFFFFFFFFFFFFFFFFFFFFFBBBBBBBBB
BBBBBBBBBFFFFFFFFFFFFFFFFBBBBBBBBBBBBFFFFFFFFFFFFFFFFFBBBBBBBBBBFFFFFFFFFFFFFFFFFFEFFBBBBBBBBB
BBBBBBBBBFFFFFFFFFFFFFFFFBBBBBBBBBBBBFFFFFFFFFFFFFFFFFBBBBBBBBBBFFFFFFFFFFFFFFFFFFFFFBBBBBBBBB
BBBBBBBBBFFFFFFFFFFFFFFFFBBBBBBBBBBBBFFFFFFFFFFFFFFFFFBBBBBBBBBBFFFFFFFFFFFFFFFFFFFFFBBBBBBBBB
BBBBBBBBBFFFFFFFSFFFFFFFFBBBBBBBBBBBBFFFFFFFFFFFFFFFFFBBBBBBBBBBFFFFFFFFFFFFFFFFFFFFFBBBBBBBBB
BBBBBBBBBFFFFFFFFFFFFFFFFBBBBBFFFFFFFFFFFFFFFFFFFFFFFFBBBBBBBBBBFFFFFFFFFFFFFFFFFFFFFBBBBBBBBB
BBBBBBBBBFFFFFFFFFFFFFFFFFFFFFFBBBBBBFFFFFFFFFFFFFFFFFBBBBBBBBBBFFEFFFFFFFFFFFFFFFFFFBBBBBBBBB
BBBBBBBBBFFFFFFFFFFFFFFFFBBBBBBBBBBBBFFFFFFFFFFFFFFFFFBBBBBBBBBBFFFFFFFFFFFFFFFFFFFFFBBBBBBBBB
BBBBBBBBBFFFFFFFFFFFFFFFFBBBBBBBBBBBBFFFFFFFFFFFFFFFFFFFFFFFFFFFFFFFFFFFFFFFFFFFFFFFFBBBBBBBBB
BBBBBBBBBFFFFFFFFFFFFFFFFBBBBBBBBBBBBFFFFFFFFFFFFFFFFFBBBBBBBBBBFFFFFFFFFFFFFFFFFFFFFBBBBBBBBB
BBBBBBBBBFFFFFFFFFFFFFFFFBBBBBBBBBBBBFFEFFFFFFFFFFFFFFBBBBBBBBBBFFFFFFFFFFFFFFFFFFFFFBBBBBBBBB
BBBBBBBBBFFFFFFFFFFFFFFFFBBBBBBBBBBBBFFFFFFFFFFFFFFFFFBBBBBBBBBBFFFFFFFFFFFFFFFSFFFFFBBBBBBBBB
BBBBBBBBBFFFFFFFFFFFFFFFFBBBBBBBBBBBBFFFFFFFFFFFFFFFFFBBBBBBBBBBFFFFFFFFFFFFFFFFFFFFFBBBBBBBBB
BBBBBBBBBBBBBBBFBBBBBBBBBBBBBBBBBBBBBBBBBBBBBBBBBBBFBBBBBBBBBBBBFFFFFFFFFFFFFFFFFFFFFBBBBBBBBB
BBBBBBBBBBBBBBBFBBBBBBBBBBBBBBBBBBBBBBBBBBBBBBBBBBBFBBBBBBBBBBBBBFBBBBBBBBBBBBBBBFBBBBBBBBBBBB
BBBBBBBBBBBBBBBFBBBBBBBBBBBBBBBBBBBBBBBBBBBBBBBBBBBFBBBBBBBBBBBBBFBBBBBBBBBBBBBBBFBBBBBBBBBBBB
BBBBBBBBBBBBBBFFBBBBBBBBBBBBBBBBBBBBBBBBBBBBBBBBBBBFBBBBBBBBBBBBBFBBBBBBBBBBBBBBBFBBBBBBBBBBBB
BBBBBBBBBBBBBBFBBBBBBBBBBBBBBBBBBBBBBBBBBBBBBBBBBBBFBBBBBBBBBBBBBFBBBBBBBBBBBBBBBFBBBBBBBBBBBB
BBBBBBBBBBBBBBFBBBBBBBBBBBBBBBBBBBBBBBBBBBBBBBBBBBBFBBBBBBBBBBBBBFBBBBBBBBBBBBBBBFBBBBBBBBBBBB
BBBBBBBBBBBBBBFBBBBBBBBBBBBBBBBBBBBBBBBBBBBBBBBBBBBFBBBBBBBBBBBBBFBBBBBBBBBBBBBBBFBBBBBBBBBBBB
BBBBBBBBBBBBBBFBBBBBBBBBBBBBBBBBBBBBBBBBBBBBBBBBBBBFBBBBBBBBBBBBBFBBBBBBBBBBBBBBBFBBBBBBBBBBBB
BBBBBBBBBFFFFFFFFFFFFFFFFBBBBBBBBBBBBBBBBBBBBBBBBBBFBBBBBBBBBBBBBFBBBBBBBBBBBBBBBFBBBBBBBBBBBB
BBBBBBBBBFFFFFFFFFFFFFFFFBBBBBBBBBBBBBBBBBBBBBBBBBBFBBBBBBBBBBBBFFBBBBBBBBBBBBBBBFBBBBBBBBBBBB
BBBBBBBBBFFFFFFFFFFFFFFFFBBBBBBBBBBBBBBBBBBBBBBBBBBFFBBBBBBBBBBFFBBBBBBBBBBBBBBBBFBBBBBBBBBBBB
BBBBBBBBBFEFFFFFFFFFFFFFFBBBBBBBBBBBBBBBBBBBBBBBBBBBFBBBBBBBBBBFBBBBBBBBBBBBBBBBBFBBBBBBBBBBBB
BBBBBBBBBFFFFFFFFFFFFFFFFBBBBBBBBBBBBBBBBBBBBBBBBBBBFBBBBBFFFFFFBBBBBBBBBBBBBBBBBFBBBBBBBBBBBB
BBBBBBBBBFFFFFFFFFFFFFFFFBBBBBBBBBBBBBBBBBBBBBBBBBBBFFFBFFFBBBBBBBBBBBBBBBBBBBBBBFBBBBBBBBBBBB
BBBBBBBBBFFFFFFFFFFFFFFFFBBBBBBBBBBBBBBBBBBBBBBBBBBBBBFBFBBBBBBBBBBBBBBBBBBBBBBBBFBBBBBBBBBBBB
BBBBBBBBBFFFFFFFFFFFFFFFFBBBBFFFFFFFFFFFFFBBBBBBBBBBBBFFFBBBBBBBBBBBBBBBBBBBBBBBBFBBBBBBBBBBBB
BBBBBBBBBFFFFFFFFFFFFFFFFBBBBFFFFFFFFFFFFFBBBBBBBBBBBBBFFBBBBBBBBBBBBBBBBBBBBBBBBFBBBBBBBBBBBB
BBBBBBBBBFFFFFFFFFFFFFFFFBBBBFFFFFFFFFFFFFBBBBBBBBBBBBBFBBBBBBBBBBBBBBBBBBBBBBBBBFBBBBBBBBBBBB
BBBBBBBBBFFFFFFFFFFFFFFFFBBBBFFFFFFFFFFFFFBBBBBBBBBBBBBFBBBBBBBBBBBBBBBBBBBBBBBBBFBBBBBBBBBBBB
BBBBBBBBBFFFFFFFFFFFFFFFFBBBBFFFFFFFFFSFFFBBBBBBBBBBBBBFBBBBBBBBBBBBBBBBBBBBBBBBBFBBBBBBBBBBBB
BBBBBBBBBFFFFFFFFFFFFFFFFBBBBFFFFFFFFFFFFFBBBBBBBBBBBBBFBBBBBBBBBBBBBBBBBBBBBBBBBFBBBBBBBBBBBB
BBBBBBBBBFFFFFFFFFFFFFFFFBBBBFFFFFFFFFFFFFBBBBBBBBBBBBBFBBBBBBBBBBBBBBBBBBBBBBBBBFBBBBBBBBBBBB
BBBBBBBBBFFFFFFFFFFFFFFFFBBBBFFFFFFFFFFFFFBBBBBBBBBBBBBFBBBBBBBBBBBBBBBBBBBBBBBBBFBBBBBBBBBBBB
BBBBBBBBBFFFFFFFFFFFFFFFFBBBBFFFFFFFFFFFFFBBBBBBBBBBBBBFBBBBBBBBBBBBBBBBBBBBBBBBBFBBBBBBBBBBBB
BBBBBBBBBBBFBBBBBBBBBBFBBBBBBFFFFFFFFFFFFFBBBBFFFFFFFFFFFFFFFFFFFFFFFFFFFFFFFFFFFFFFFBBBBBBBBB
BBBBBBBBBBBFBBBBBBBBBBFBBBBBBFFFFFFFFFFFFFBBBBFFFFFFFFFFFFFFFFFFFFFFFFFFFFFFFFFFFFFFFBBBBBBBBB
BBBBBBBBBBBFBBBBBBBBBBFBBBBBBFFFFFFFFFFFFFBBBBFFFGFFFFFFFFFFFFEFFFFFFFFFFFFFEFFFFFFFFBBBBBBBBB
BBBBBBBBBBBFBBBBBBBBBBFBBBBBBFFFFFFFFFFFFFBBBBFFFFFFFFFFFFFFFFFFFFFFFFFFFFFFFFFFFFFFFBBBBBBBBB
BBBBBBBBBBBFBBBBBBBBBBFFFFFFFFFFFFFFFFFFFFBBBBFFFFFFFFFFFFFFFFFFFFFFFFFFFFFFFFFFFFFFFBBBBBBBBB
BBBBBBBBBBBFBBBBBBBBBBBBBBBBBFFEFFFFFFFFFFBBBBFFFFFFFFFFFFFFFFFFFFFFFFFFFFFFFFFFFFFFFBBBBBBBBB
BBBBBBBBBBBFBBBBBBBBBBBBBBBBBFFFFFFFFFFFFFBBBBFFFFFFFFFFFFFFFFFFFFFFFFFFFFFFFFFFFFFFFBBBBBBBBB
BBBBBBBBBBBFBBBBBBBBBBBBBBBBBFFFFFFFFFFFFFBBBBFFFFFFFFFFFEFFFFFFFFFFFFFFFFFFFFFFFFFFFBBBBBBBBB
BBBBBBBBBBBFBBBBBBBBBBBBBBBBBBBBBBBBBBBBBBBBBBFFFFFFFFFFFFFFFFFFFFFFFFFFFFFFFFFFFFFFFBBBBBBBBB
BBBBBBBBBBBFBBBBBBBBBBBBBBBBBBBBBBBBBBBBBBBBBBFFFFFFFFFFFFFFFFFFFFFFFFFFFFFFFFFFFFFFFBBBBBBBBB
BBBBBBBBBFFFFFFFFFFFFBBBBBBBBBBBBBBBBBBBBBBBBBFFFFFFFFFFFFFFFFFFFFFFFFFFFFFFFFFFFFFFFBBBBBBBBB
BBBBBBBBBFFFFFFFFFFFFBBBBBBBBBBBBBBBBBBBBBBBBBFFFFFFFFFFFFFFFFFFFFFFFFFFFFFFFFFFFFFFFBBBBBBBBB
BBBBBBBBBFFFFFFFFFFFFBBBBBBBBBBBBBBBBBBBBBBBBBFFFFFFFFFFFFFFFFFFFFFFFFFFFFFFFFFFFFFFFBBBBBBBBB
BBBBBBBBBFFFFFFFFFEFFBBBBBBBBBBBBFFFFFFFFFFFFFFFEFFFFFFFFFFFFFFFFFFFFFFFFFFFFFFFFFFFFBBBBBBBBB
BBBBBBBBBFFFFFFFFFFFFBBBBBBBBBBBBFBBBBBBBBBBBBFFFFFFFFFFFFFFFFFFFFFFFFFFFFFFFFFFFFFFFBBBBBBBBB
BBBBBBBBBFFFFFFFFFFFFBBBBBBBBBBBBFBBBBBBBBBBBBFFFFFFFFFFFFFFFFFFFFFFEFFFFFFFFFFFFEFFFBBBBBBBBB
BBBBBBBBBFFFFFFFFFFFFBBBBBBBBBBBBFBBBBBBBBBBBBFFFFFFFFFFFFFFFFFFFFFFFFFFFFFFFFFFFFFFFBBBBBBBBB
BBBBBBBBBFFFFFFFFFFFFBBBBBBBBBBBBFBBBBBBBBBBBBFFFFFFFFFFFFFFFFFFFFFFFFFFFFFFFFFFFFFFFBBBBBBBBB
BBBBBBBBBFFFFFFFFFFFFBBBBBBBBBBBBFBBBBBBBBBBBBBBBBBBBBBBBBBBBBBBBBBBBBBBBBBBBBBBBFBBBBBBBBBBBB
BBBBBBBBBFFFFFFFFFFFFFFFFFFFFFFFFFBBBBBBBBBBBBBBBBBBBBBBBBBBBBBBBBBBBBBBBBBBBBBBBFBBBBBBBBBBBB
BBBBBBBBBFFFFFFFFFFFFBBBBBBBBBBBBBBBBBBBBBBBBBBBBBBBBBBBBBBBBBBBBBBBBBBBBBBBBBBBBFBBBBBBBBBBBB
BBBBBBBBBFFFFFFFFFFFFBBBBBBBBBBBBFFFFFFFFFFFFFFFFFFBBBBBBBBBBBBBBBBBBBBBBBBBBBBBBFBBBBBBBBBBBB
BBBBBBBBBBBBBBBBBBBBBBBBBBBBBBBBBFFFFFFFFFFFFFFFFFFBBBBBBBBBBBBBBBBBBBBBBBBBBBBBBFBBBBBBBBBBBB
BBBBBBBBBBBBBBBBBBBBBBBBBBBBBBBBBFFFFFFFFFFFFFFFFFFBBBBBBBBBBBBBBBBBBBBBBBBBBBBBBFBBBBBBBBBBBB
BBBBBBBBBFFFFFFFFBBBBBBBBBBBBBBBBFFFFFFFFFFFFFSFFFFBBBBBBBBBBBBBBBBBBBBBBBBBBBBBBFBBBBBBBBBBBB
BBBBBBBBBFFGFFFFFBBBBBBBBBBBBBBBBFFFFFFFFEFFFFFFFFFBBBBBBBBBBBBBBBBBBBBBBBBBBBBBBFBBBBBBBBBBBB
BBBBBBBBBFFFFFFFFBBBBBBBBBBBBBBBBFFFFFFFFFFFFFFFFFFBBBBBBBBBBBBBBBBBBBBBBBBBBBBBBFBBBBBBBBBBBB
BBBBBBBBBFFFFFEFFBBBBBBBBBBBBBBBBFFFEFFFFFFFFFFFFFFBBBBBBBBBBBBBBBBBBBBBBBBBBBBBBFBBBBBBBBBBBB
BBBBBBBBBFEFFFFFFBBBBBBBBBBBBBBBBFFFFFFFFFFFFFFFFFFBBBBBBBBBBBBBBBFFFFFFFFBBBBBBBFBBBBBBBBBBBB
BBBBBBBBBFFFFFFFFBBBBBFFFFFFFFFFFFFFFFFFFFFFFFFFFFFBBBBBBBBBBBBBBBFFFFFFFFBBBBBBBFBBBBBBBBBBBB
BBBBBBBBBFFFFFFFFBBBFFFBBBBBBBBBBFFFFFFFFFFFFFFFFFFBBBBBBBBBBBBBBBFFFFFFFFBBBBBBFFBBBBBBBBBBBB
BBBBBBBBBFFFFFFFFBBFFBBBBBBBBBBBBFFFFFFFFFFFFFFFFFFBBBBBBBBBBBBBBBFFFFFFFFBBBBBBFBBBBBBBBBBBBB
BBBBBBBBBFFFFFFFFFFFBBBBBBBBBBBBBFFFFFFFFFFFFFFFFFFBBBBBBBBBBBBBBBFFFFFFFFBBBBBBFBBBBBBBBBBBBB
BBBBBBBBBFFFFFFFFBBBBBBBBBBBBBBBBFFFFEFFFFFFFFEFFFFFFFFFFFFFFFFFFFFFFFFFFFBBBBBBFBBBBBBBBBBBBB
BBBBBBBBBFFFEFFFFBBBBBBBBBBBBBBBBFFFFFFFFFFFFFFFFFFBBBBBBBBBBBBBBBFFFFFFGFFFFFFFFBBBBBBBBBBBBB
BBBBBBBBBFFFFFFFFBBBBBBBBBBBBBBBBFFFFFFFFFFFFFFFFFFBBBBBBBBBBBBBBBFFFFFFFFBBBBBBBBBBBBBBBBBBBB
BBBBBBBBBBBBBBBBBBBBBBBBBBBBBBBBBBBBBBBBBBBBBBBBBBBBBBBBBBBBBBBBBBBBBBBBBBBBBBBBBBBBBBBBBBBBBB
BBBBBBBBBBBBBBBBBBBBBBBBBBBBBBBBBBBBBBBBBBBBBBBBBBBBBBBBBBBBBBBBBBBBBBBBBBBBBBBBBBBBBBBBBBBBBB
BBBBBBBBBBBBBBBBBBBBBBBBBBBBBBBBBBBBBBBBBBBBBBBBBBBBBBBBBBBBBBBBBBBBBBBBBBBBBBBBBBBBBBBBBBBBBB
BBBBBBBBBBBBBBBBBBBBBBBBBBBBBBBBBBBBBBBBBBBBBBBBBBBBBBBBBBBBBBBBBBBBBBBBBBBBBBBBBBBBBBBBBBBBBB
BBBBBBBBBBBBBBBBBBBBBBBBBBBBBBBBBBBBBBBBBBBBBBBBBBBBBBBBBBBBBBBBBBBBBBBBBBBBBBBBBBBBBBBBBBBBBB
BBBBBBBBBBBBBBBBBBBBBBBBBBBBBBBBBBBBBBBBBBBBBBBBBBBBBBBBBBBBBBBBBBBBBBBBBBBBBBBBBBBBBBBBBBBBBB
BBBBBBBBBBBBBBBBBBBBBBBBBBBBBBBBBBBBBBBBBBBBBBBBBBBBBBBBBBBBBBBBBBBBBBBBBBBBBBBBBBBBBBBBBBBBBB